state,county,code,r,d,rp,dp,t
KY,Adair,21001,3856,4651,45.33,54.67,8507
KY,Allen,21003,9260,4191,68.84,31.16,13451
KY,Anderson,21005,3596,5550,39.32,60.68,9146
KY,Ballard,21007,2034,1849,52.38,47.62,3883
KY,Barren,21009,5757,6025,48.86,51.14,11782
KY,Bath,21011,7111,1172,85.85,14.15,8283
KY,Bell,21013,6274,3274,65.71,34.29,9548
KY,Boone,21015,2835,159,94.69,5.31,2994
KY,Bourbon,21017,575,2975,16.20,83.80,3550
KY,Boyd,21019,6707,1556,81.17,18.83,8263
KY,Boyle,21021,9370,2688,77.71,22.29,12058
KY,Bracken,21023,2405,942,71.86,28.14,3347
KY,Breathitt,21025,9020,5825,60.76,39.24,14845
KY,Breckinridge,21027,4633,1444,76.24,23.76,6077
KY,Bullitt,21029,3403,3736,47.67,52.33,7139
KY,Butler,21031,404,6894,5.54,94.46,7298
KY,Caldwell,21033,2195,2733,44.54,55.46,4928
KY,Calloway,21035,1977,3001,39.71,60.29,4978
KY,Campbell,21037,3822,8290,31.56,68.44,12112
KY,Carlisle,21039,2099,4699,30.88,69.12,6798
KY,Carroll,21041,7352,559,92.93,7.07,7911
KY,Carter,21043,1305,3709,26.03,73.97,5014
KY,Casey,21045,6387,5604,53.26,46.74,11991
KY,Christian,21047,9634,9608,50.07,49.93,19242
KY,Clark,21049,6879,2823,70.90,29.10,9702
KY,Clay,21051,4996,4033,55.33,44.67,9029
KY,Clinton,21053,5370,3244,62.34,37.66,8614
KY,Crittenden,21055,9518,823,92.04,7.96,10341
KY,Cumberland,21057,3071,6168,33.24,66.76,9239
KY,Daviess,21059,1911,416,82.12,17.88,2327
KY,Edmonson,21061,1869,1826,50.58,49.42,3695
KY,Elliott,21063,4238,891,82.63,17.37,5129
KY,Estill,21065,3042,7921,27.75,72.25,10963
KY,Fayette,21067,9988,1220,89.11,10.89,11208
KY,Fleming,21069,258,578,30.86,69.14,836
KY,Floyd,21071,9407,6124,60.57,39.43,15531
KY,Franklin,21073,9298,1590,85.40,14.60,10888
KY,Fulton,21075,5594,2691,67.52,32.48,8285
KY,Gallatin,21077,129,719,15.21,84.79,848
KY,Garrard,21079,856,3444,19.91,80.09,4300
KY,Grant,21081,9894,9225,51.75,48.25,19119
KY,Graves,21083,9226,3601,71.93,28.07,12827
KY,Grayson,21085,6567,2170,75.16,24.84,8737
KY,Green,21087,7526,209,97.30,2.70,7735
KY,Greenup,21089,335,7468,4.29,95.71,7803
KY,Hancock,21091,406,9136,4.25,95.75,9542
KY,Hardin,21093,1430,4458,24.29,75.71,5888
KY,Harlan,21095,138,6383,2.12,97.88,6521
KY,Harrison,21097,9177,4909,65.15,34.85,14086
KY,Hart,21099,6500,2176,74.92,25.08,8676
KY,Henderson,21101,3667,3501,51.16,48.84,7168
KY,Henry,21103,3298,2846,53.68,46.32,6144
KY,Hickman,21105,1554,3211,32.61,67.39,4765
KY,Hopkins,21107,6521,8717,42.79,57.21,15238
KY,Jackson,21109,1471,9437,13.49,86.51,10908
KY,Jefferson,21111,6734,149,97.84,2.16,6883
KY,Jessamine,21113,196,3970,4.70,95.30,4166
KY,Johnson,21115,2219,9107,19.59,80.41,11326
KY,Kenton,21117,7422,9598,43.61,56.39,17020
KY,Knott,21119,9915,5652,63.69,36.31,15567
KY,Knox,21121,6928,5841,54.26,45.74,12769
KY,LaRue,21123,1552,9461,14.09,85.91,11013
KY,Laurel,21125,9528,2368,80.09,19.91,11896
KY,Lawrence,21127,4210,4861,46.41,53.59,9071
KY,Lee,21129,6885,135,98.08,1.92,7020
KY,Leslie,21131,6453,6047,51.62,48.38,12500
KY,Letcher,21133,572,4861,10.53,89.47,5433
KY,Lewis,21135,5773,3805,60.27,39.73,9578
KY,Lincoln,21137,5461,4576,54.41,45.59,10037
KY,Livingston,21139,8910,7651,53.80,46.20,16561
KY,Logan,21141,975,5070,16.13,83.87,6045
KY,Lyon,21143,6067,9984,37.80,62.20,16051
KY,McCracken,21145,372,7607,4.66,95.34,7979
KY,McCreary,21147,7182,847,89.45,10.55,8029
KY,McLean,21149,6157,7843,43.98,56.02,14000
KY,Madison,21151,1038,7634,11.97,88.03,8672
KY,Magoffin,21153,1987,9059,17.99,82.01,11046
KY,Marion,21155,186,7597,2.39,97.61,7783
KY,Marshall,21157,6662,2290,74.42,25.58,8952
KY,Martin,21159,3222,8582,27.30,72.70,11804
KY,Mason,21161,2493,8600,22.47,77.53,11093
KY,Meade,21163,4792,2188,68.65,31.35,6980
KY,Menifee,21165,6181,8713,41.50,58.50,14894
KY,Mercer,21167,6870,2788,71.13,28.87,9658
KY,Metcalfe,21169,636,5625,10.16,89.84,6261
KY,Monroe,21171,7838,511,93.88,6.12,8349
KY,Montgomery,21173,9653,4568,67.88,32.12,14221
KY,Morgan,21175,6711,9430,41.58,58.42,16141
KY,Muhlenberg,21177,7127,5278,57.45,42.55,12405
KY,Nelson,21179,1908,1091,63.62,36.38,2999
KY,Nicholas,21181,9833,7173,57.82,42.18,17006
KY,Ohio,21183,2611,6146,29.82,70.18,8757
KY,Oldham,21185,9259,2092,81.57,18.43,11351
KY,Owen,21187,8355,3666,69.50,30.50,12021
KY,Owsley,21189,6747,6483,51.00,49.00,13230
KY,Pendleton,21191,7398,4093,64.38,35.62,11491
KY,Perry,21193,5994,1840,76.51,23.49,7834
KY,Pike,21195,4120,1161,78.02,21.98,5281
KY,Powell,21197,1017,2776,26.81,73.19,3793
KY,Pulaski,21199,2232,6550,25.42,74.58,8782
KY,Robertson,21201,3121,5033,38.28,61.72,8154
KY,Rockcastle,21203,1090,1319,45.25,54.75,2409
KY,Rowan,21205,363,7324,4.72,95.28,7687
KY,Russell,21207,5789,1718,77.11,22.89,7507
KY,Scott,21209,785,317,71.23,28.77,1102
KY,Shelby,21211,7042,9596,42.32,57.68,16638
KY,Simpson,21213,9202,3179,74.32,25.68,12381
KY,Spencer,21215,1851,2037,47.61,52.39,3888
KY,Taylor,21217,6786,9273,42.26,57.74,16059
KY,Todd,21219,6605,8132,44.82,55.18,14737
KY,Trigg,21221,1124,4365,20.48,79.52,5489
KY,Trimble,21223,9664,4689,67.33,32.67,14353
KY,Union,21225,9079,5955,60.39,39.61,15034
KY,Warren,21227,7535,1089,87.37,12.63,8624
KY,Washington,21229,8109,2248,78.29,21.71,10357
KY,Wayne,21231,4423,319,93.27,6.73,4742
KY,Webster,21233,9515,2765,77.48,22.52,12280
KY,Whitley,21235,3381,599,84.95,15.05,3980
KY,Wolfe,21237,7816,2247,77.67,22.33,10063
KY,Woodford,21239,2653,5288,33.41,66.59,7941
IA,Adair,19001,7258,6389,53.18,46.82,13647
IA,Adams,19003,7641,4125,64.94,35.06,11766
IA,Allamakee,19005,8925,9893,47.43,52.57,18818
IA,Appanoose,19007,1165,5811,16.70,83.30,6976
IA,Audubon,19009,3242,9232,25.99,74.01,12474
IA,Benton,19011,7818,4401,63.98,36.02,12219
IA,Black Hawk,19013,765,5959,11.38,88.62,6724
IA,Boone,19015,139,798,14.83,85.17,937
IA,Bremer,19017,3253,3988,44.92,55.08,7241
IA,Buchanan,19019,9592,6514,59.56,40.44,16106
IA,Buena Vista,19021,3630,8182,30.73,69.27,11812
IA,Butler,19023,4454,4382,50.41,49.59,8836
IA,Calhoun,19025,7581,4969,60.41,39.59,12550
IA,Carroll,19027,8415,1324,86.41,13.59,9739
IA,Cass,19029,2231,1139,66.20,33.80,3370
IA,Cedar,19031,7836,4475,63.65,36.35,12311
IA,Cerro Gordo,19033,8325,3120,72.74,27.26,11445
IA,Cherokee,19035,1920,128,93.75,6.25,2048
IA,Chickasaw,19037,3740,2902,56.31,43.69,6642
IA,Clarke,19039,6929,5792,54.47,45.53,12721
IA,Clay,19041,9165,1144,88.90,11.10,10309
IA,Clayton,19043,5834,3030,65.82,34.18,8864
IA,Clinton,19045,3117,9462,24.78,75.22,12579
IA,Crawford,19047,1157,1350,46.15,53.85,2507
IA,Dallas,19049,6816,7419,47.88,52.12,14235
IA,Davis,19051,289,1587,15.41,84.59,1876
IA,Decatur,19053,5518,357,93.92,6.08,5875
IA,Delaware,19055,9580,8652,52.54,47.46,18232
IA,Des Moines,19057,7218,4532,61.43,38.57,11750
IA,Dickinson,19059,4229,4133,50.57,49.43,8362
IA,Dubuque,19061,2634,4260,38.21,61.79,6894
IA,Emmet,19063,2809,4421,38.85,61.15,7230
IA,Fayette,19065,5053,5282,48.89,51.11,10335
IA,Floyd,19067,8818,7042,55.60,44.40,15860
IA,Franklin,19069,6503,3787,63.20,36.80,10290
IA,Fremont,19071,1317,5067,20.63,79.37,6384
IA,Greene,19073,8456,7544,52.85,47.15,16000
IA,Grundy,19075,7052,4306,62.09,37.91,11358
IA,Guthrie,19077,3033,2873,51.35,48.65,5906
IA,Hamilton,19079,6439,311,95.39,4.61,6750
IA,Hancock,19081,8076,9682,45.48,54.52,17758
IA,Hardin,19083,7428,2799,72.63,27.37,10227
IA,Harrison,19085,990,8513,10.42,89.58,9503
IA,Henry,19087,7478,8945,45.53,54.47,16423
IA,Howard,19089,1602,2616,37.98,62.02,4218
IA,Humboldt,19091,3453,462,88.20,11.80,3915
IA,Ida,19093,6591,9664,40.55,59.45,16255
IA,Iowa,0,3443,7436,31.65,68.35,10879
IA,Jackson,19097,5305,6245,45.93,54.07,11550
IA,Jasper,19099,6119,2172,73.80,26.20,8291
IA,Jefferson,19101,5674,2424,70.07,29.93,8098
IA,Johnson,19103,5699,6265,47.63,52.37,11964
IA,Jones,19105,8044,4041,66.56,33.44,12085
IA,Keokuk,19107,3817,7179,34.71,65.29,10996
IA,Kossuth,19109,897,2460,26.72,73.28,3357
IA,Lee,19111,1203,7499,13.82,86.18,8702
IA,Linn,19113,3038,4652,39.51,60.49,7690
IA,Louisa,19115,5893,4747,55.39,44.61,10640
IA,Lucas,19117,534,4894,9.84,90.16,5428
IA,Lyon,19119,2739,8442,24.50,75.50,11181
IA,Madison,19121,7191,2544,73.87,26.13,9735
IA,Mahaska,19123,6010,4795,55.62,44.38,10805
IA,Marion,19125,1689,7656,18.07,81.93,9345
IA,Marshall,19127,9277,455,95.32,4.68,9732
IA,Mills,19129,1291,268,82.81,17.19,1559
IA,Mitchell,19131,6219,3326,65.15,34.85,9545
IA,Monona,19133,1401,5428,20.52,79.48,6829
IA,Monroe,19135,7235,1081,87.00,13.00,8316
IA,Montgomery,19137,8461,7572,52.77,47.23,16033
IA,Muscatine,19139,5009,5353,48.34,51.66,10362
IA,O'Brien,19141,7928,686,92.04,7.96,8614
IA,Osceola,19143,331,3981,7.68,92.32,4312
IA,Page,19145,4702,4619,50.45,49.55,9321
IA,Palo Alto,19147,1399,4919,22.14,77.86,6318
IA,Plymouth,19149,1463,3866,27.45,72.55,5329
IA,Pocahontas,19151,1420,7923,15.20,84.80,9343
IA,Polk,19153,3152,8930,26.09,73.91,12082
IA,Pottawattamie,19155,5246,8641,37.78,62.22,13887
IA,Poweshiek,19157,9736,5438,64.16,35.84,15174
IA,Ringgold,19159,885,9305,8.68,91.32,10190
IA,Sac,19161,9976,6675,59.91,40.09,16651
IA,Scott,19163,2446,4466,35.39,64.61,6912
IA,Shelby,19165,6396,2928,68.60,31.40,9324
IA,Sioux,19167,6261,6467,49.19,50.81,12728
IA,Story,19169,3814,5929,39.15,60.85,9743
IA,Tama,19171,9364,2887,76.43,23.57,12251
IA,Taylor,19173,1146,7146,13.82,86.18,8292
IA,Union,19175,6383,7595,45.66,54.34,13978
IA,Van Buren,19177,8915,8671,50.69,49.31,17586
IA,Wapello,19179,6620,511,92.83,7.17,7131
IA,Warren,19181,5295,9622,35.50,64.50,14917
IA,Washington,19183,9197,7650,54.59,45.41,16847
IA,Wayne,19185,9318,6327,59.56,40.44,15645
IA,Webster,19187,3261,580,84.90,15.10,3841
IA,Winnebago,19189,7393,7090,51.05,48.95,14483
IA,Winneshiek,19191,3669,2687,57.72,42.28,6356
IA,Woodbury,19193,9812,4640,67.89,32.11,14452
IA,Worth,19195,1674,3396,33.02,66.98,5070
IA,Wright,19197,5380,8020,40.15,59.85,13400
GA,Appling,13001,9169,5095,64.28,35.72,14264
GA,Atkinson,13003,9175,2009,82.04,17.96,11184
GA,Bacon,13005,4245,8638,32.95,67.05,12883
GA,Baker,13007,7679,4774,61.66,38.34,12453
GA,Baldwin,13009,8265,4085,66.92,33.08,12350
GA,Banks,13011,7835,4312,64.50,35.50,12147
GA,Barrow,13013,8510,1444,85.49,14.51,9954
GA,Bartow,13015,4600,8349,35.52,64.48,12949
GA,Ben Hill,13017,9790,6061,61.76,38.24,15851
GA,Berrien,13019,9113,592,93.90,6.10,9705
GA,Bibb,13021,9164,9274,49.70,50.30,18438
GA,Bleckley,13023,3067,2959,50.90,49.10,6026
GA,Brantley,13025,6512,1346,82.87,17.13,7858
GA,Brooks,13027,1438,1513,48.73,51.27,2951
GA,Bryan,13029,2503,1474,62.94,37.06,3977
GA,Bulloch,13031,2386,3441,40.95,59.05,5827
GA,Burke,13033,6457,7874,45.06,54.94,14331
GA,Butts,13035,1254,2291,35.37,64.63,3545
GA,Calhoun,13037,4571,8358,35.35,64.65,12929
GA,Camden,13039,1092,8190,11.76,88.24,9282
GA,Candler,13043,9223,596,93.93,6.07,9819
GA,Carroll,13045,6064,3922,60.73,39.27,9986
GA,Catoosa,13047,5716,6792,45.70,54.30,12508
GA,Charlton,13049,8284,7542,52.34,47.66,15826
GA,Chatham,13051,5551,1763,75.90,24.10,7314
GA,Chattahoochee,13053,3099,2076,59.88,40.12,5175
GA,Chattooga,13055,6897,2088,76.76,23.24,8985
GA,Cherokee,13057,8909,1616,84.65,15.35,10525
GA,Clarke,13059,9608,1438,86.98,13.02,11046
GA,Clay,13061,5945,2902,67.20,32.80,8847
GA,Clayton,13063,2287,1583,59.10,40.90,3870
GA,Clinch,13065,1773,2819,38.61,61.39,4592
GA,Cobb,13067,335,8254,3.90,96.10,8589
GA,Coffee,13069,8301,7113,53.85,46.15,15414
GA,Colquitt,13071,7182,8490,45.83,54.17,15672
GA,Columbia,13073,1251,4181,23.03,76.97,5432
GA,Cook,13075,6128,6769,47.51,52.49,12897
GA,Coweta,13077,9380,6550,58.88,41.12,15930
GA,Crawford,13079,6895,444,93.95,6.05,7339
GA,Crisp,13081,8473,5871,59.07,40.93,14344
GA,Dade,13083,8196,3731,68.72,31.28,11927
GA,Dawson,13085,4604,3027,60.33,39.67,7631
GA,Decatur,13087,6576,8690,43.08,56.92,15266
GA,DeKalb,13089,8745,9136,48.91,51.09,17881
GA,Dodge,13091,8565,4430,65.91,34.09,12995
GA,Dooly,13093,2068,3536,36.90,63.10,5604
GA,Dougherty,13095,9144,3149,74.38,25.62,12293
GA,Douglas,13097,7947,6568,54.75,45.25,14515
GA,Early,13099,5958,2814,67.92,32.08,8772
GA,Echols,13101,7666,3597,68.06,31.94,11263
GA,Effingham,13103,3292,5086,39.29,60.71,8378
GA,Elbert,13105,8978,3634,71.19,28.81,12612
GA,Emanuel,13107,2930,911,76.28,23.72,3841
GA,Evans,13109,168,2853,5.56,94.44,3021
GA,Fannin,13111,695,5072,12.05,87.95,5767
GA,Fayette,13113,870,458,65.51,34.49,1328
GA,Floyd,13115,1141,6319,15.29,84.71,7460
GA,Forsyth,13117,1806,5469,24.82,75.18,7275
GA,Franklin,13119,5557,8062,40.80,59.20,13619
GA,Fulton,13121,2006,9955,16.77,83.23,11961
GA,Gilmer,13123,8584,2470,77.66,22.34,11054
GA,Glascock,13125,8018,5839,57.86,42.14,13857
GA,Glynn,13127,5218,2649,66.33,33.67,7867
GA,Gordon,13129,1909,2895,39.74,60.26,4804
GA,Grady,13131,1089,8832,10.98,89.02,9921
GA,Greene,13133,3908,9158,29.91,70.09,13066
GA,Gwinnett,13135,4480,3081,59.25,40.75,7561
GA,Habersham,13137,2219,8526,20.65,79.35,10745
GA,Hall,13139,5019,7961,38.67,61.33,12980
GA,Hancock,13141,6044,6859,46.84,53.16,12903
GA,Haralson,13143,2475,1895,56.64,43.36,4370
GA,Harris,13145,265,361,42.33,57.67,626
GA,Hart,13147,3331,7055,32.07,67.93,10386
GA,Heard,13149,445,3049,12.74,87.26,3494
GA,Henry,13151,9246,8120,53.24,46.76,17366
GA,Houston,13153,1128,6597,14.60,85.40,7725
GA,Irwin,13155,787,1724,31.34,68.66,2511
GA,Jackson,13157,7902,5989,56.89,43.11,13891
GA,Jasper,13159,9507,9211,50.79,49.21,18718
GA,Jeff Davis,13161,4659,9190,33.64,66.36,13849
GA,Jefferson,13163,9593,6697,58.89,41.11,16290
GA,Jenkins,13165,6305,9201,40.66,59.34,15506
GA,Johnson,13167,4970,7519,39.80,60.20,12489
GA,Jones,13169,665,9773,6.37,93.63,10438
GA,Lamar,13171,3757,5309,41.44,58.56,9066
GA,Lanier,13173,4565,2026,69.26,30.74,6591
GA,Laurens,13175,2002,2312,46.41,53.59,4314
GA,Lee,13177,4835,3256,59.76,40.24,8091
GA,Liberty,13179,5462,8058,40.40,59.60,13520
GA,Lincoln,13181,4820,4644,50.93,49.07,9464
GA,Long,13183,2562,6943,26.95,73.05,9505
GA,Lowndes,13185,1609,1602,50.11,49.89,3211
GA,Lumpkin,13187,3709,5131,41.96,58.04,8840
GA,Macon,13193,6594,2939,69.17,30.83,9533
GA,Madison,13195,1338,5789,18.77,81.23,7127
GA,Marion,13197,1014,8971,10.16,89.84,9985
GA,McDuffie,13189,7233,2711,72.74,27.26,9944
GA,McIntosh,13191,8203,5988,57.80,42.20,14191
GA,Meriwether,13199,6766,7330,48.00,52.00,14096
GA,Miller,13201,2602,8273,23.93,76.07,10875
GA,Mitchell,13205,354,7105,4.75,95.25,7459
GA,Monroe,13207,2949,2680,52.39,47.61,5629
GA,Montgomery,13209,7151,7167,49.94,50.06,14318
GA,Morgan,13211,3986,7528,34.62,65.38,11514
GA,Murray,13213,4836,4901,49.67,50.33,9737
GA,Muscogee,13215,2295,9066,20.20,79.80,11361
GA,Newton,13217,4156,6485,39.06,60.94,10641
GA,Oconee,13219,2464,4900,33.46,66.54,7364
GA,Oglethorpe,13221,6746,543,92.55,7.45,7289
GA,Paulding,13223,9738,9543,50.51,49.49,19281
GA,Peach,13225,4886,2383,67.22,32.78,7269
GA,Pickens,13227,3754,5712,39.66,60.34,9466
GA,Pierce,13229,1197,2453,32.79,67.21,3650
GA,Pike,13231,7581,9444,44.53,55.47,17025
GA,Polk,13233,8042,2551,75.92,24.08,10593
GA,Pulaski,13235,7006,9695,41.95,58.05,16701
GA,Putnam,13237,6158,3007,67.19,32.81,9165
GA,Quitman,13239,5593,4198,57.12,42.88,9791
GA,Rabun,13241,2369,6926,25.49,74.51,9295
GA,Randolph,13243,9596,1486,86.59,13.41,11082
GA,Richmond,13245,4516,7210,38.51,61.49,11726
GA,Rockdale,13247,3789,9839,27.80,72.20,13628
GA,Schley,13249,1540,8881,14.78,85.22,10421
GA,Screven,13251,8255,9550,46.36,53.64,17805
GA,Seminole,13253,9357,4233,68.85,31.15,13590
GA,Spalding,13255,7711,6690,53.54,46.46,14401
GA,Stephens,13257,301,6845,4.21,95.79,7146
GA,Stewart,13259,772,989,43.84,56.16,1761
GA,Sumter,13261,2422,7492,24.43,75.57,9914
GA,Talbot,13263,8305,6699,55.35,44.65,15004
GA,Taliaferro,13265,2395,7556,24.07,75.93,9951
GA,Tattnall,13267,6410,2086,75.45,24.55,8496
GA,Taylor,13269,1430,6767,17.45,82.55,8197
GA,Telfair,13271,7535,2739,73.34,26.66,10274
GA,Terrell,13273,861,4876,15.01,84.99,5737
GA,Thomas,13275,5242,5857,47.23,52.77,11099
GA,Tift,13277,4848,9971,32.71,67.29,14819
GA,Toombs,13279,9119,8588,51.50,48.50,17707
GA,Towns,13281,6400,7633,45.61,54.39,14033
GA,Treutlen,13283,5465,8305,39.69,60.31,13770
GA,Troup,13285,4865,462,91.33,8.67,5327
GA,Turner,13287,1641,4494,26.75,73.25,6135
GA,Twiggs,13289,9015,6139,59.49,40.51,15154
GA,Union,13291,6977,977,87.72,12.28,7954
GA,Upson,13293,1243,5181,19.35,80.65,6424
GA,Walker,13295,528,1004,34.46,65.54,1532
GA,Walton,13297,4608,3435,57.29,42.71,8043
GA,Ware,13299,9137,8792,50.96,49.04,17929
GA,Warren,13301,3629,6054,37.48,62.52,9683
GA,Washington,13303,6081,4301,58.57,41.43,10382
GA,Wayne,13305,2138,7462,22.27,77.73,9600
GA,Webster,13307,763,9926,7.14,92.86,10689
GA,Wheeler,13309,1363,9974,12.02,87.98,11337
GA,White,13311,4787,8006,37.42,62.58,12793
GA,Whitfield,13313,7270,9688,42.87,57.13,16958
GA,Wilcox,13315,1692,2497,40.39,59.61,4189
GA,Wilkes,13317,2107,9590,18.01,81.99,11697
GA,Wilkinson,13319,478,6163,7.20,92.80,6641
GA,Worth,13321,4810,9172,34.40,65.60,13982
NC,Alamance,37001,3737,9013,29.31,70.69,12750
NC,Alexander,37003,8538,494,94.53,5.47,9032
NC,Alleghany,37005,3511,309,91.91,8.09,3820
NC,Anson,37007,9622,6278,60.52,39.48,15900
NC,Ashe,37009,4189,6496,39.20,60.80,10685
NC,Avery,37011,2013,852,70.26,29.74,2865
NC,Beaufort,37013,6925,7851,46.87,53.13,14776
NC,Bertie,37015,2289,6316,26.60,73.40,8605
NC,Bladen,37017,5158,9389,35.46,64.54,14547
NC,Brunswick,37019,7051,5557,55.92,44.08,12608
NC,Buncombe,37021,1647,9992,14.15,85.85,11639
NC,Burke,37023,3657,1923,65.54,34.46,5580
NC,Cabarrus,37025,6700,5002,57.26,42.74,11702
NC,Caldwell,37027,2648,2776,48.82,51.18,5424
NC,Camden,37029,5679,5227,52.07,47.93,10906
NC,Carteret,37031,4506,3721,54.77,45.23,8227
NC,Caswell,37033,1951,4546,30.03,69.97,6497
NC,Catawba,37035,7715,1534,83.41,16.59,9249
NC,Chatham,37037,9299,8063,53.56,46.44,17362
NC,Cherokee,37039,8661,8009,51.96,48.04,16670
NC,Chowan,37041,8000,8122,49.62,50.38,16122
NC,Clay,37043,749,1940,27.85,72.15,2689
NC,Cleveland,37045,4149,4864,46.03,53.97,9013
NC,Columbus,37047,2353,8511,21.66,78.34,10864
NC,Craven,37049,8209,9465,46.45,53.55,17674
NC,Cumberland,37051,8141,2912,73.65,26.35,11053
NC,Currituck,37053,2071,1087,65.58,34.42,3158
NC,Dare,37055,7216,7968,47.52,52.48,15184
NC,Davidson,37057,5281,1325,79.94,20.06,6606
NC,Davie,37059,8238,2389,77.52,22.48,10627
NC,Duplin,37061,1134,9121,11.06,88.94,10255
NC,Durham,37063,5495,5684,49.15,50.85,11179
NC,Edgecombe,37065,3424,5867,36.85,63.15,9291
NC,Forsyth,37067,4923,7988,38.13,61.87,12911
NC,Franklin,37069,3609,145,96.14,3.86,3754
NC,Gaston,37071,4753,636,88.20,11.80,5389
NC,Gates,37073,155,998,13.44,86.56,1153
NC,Graham,37075,447,9542,4.47,95.53,9989
NC,Granville,37077,1734,7446,18.89,81.11,9180
NC,Greene,37079,7482,9364,44.41,55.59,16846
NC,Guilford,37081,986,8221,10.71,89.29,9207
NC,Halifax,37083,8382,697,92.32,7.68,9079
NC,Harnett,37085,3500,3146,52.66,47.34,6646
NC,Haywood,37087,8931,3387,72.50,27.50,12318
NC,Henderson,37089,9731,9045,51.83,48.17,18776
NC,Hertford,37091,618,5216,10.59,89.41,5834
NC,Hoke,37093,996,5767,14.73,85.27,6763
NC,Hyde,37095,3325,5139,39.28,60.72,8464
NC,Iredell,37097,4410,2222,66.50,33.50,6632
NC,Jackson,37099,4202,2894,59.22,40.78,7096
NC,Johnston,37101,2697,6497,29.33,70.67,9194
NC,Jones,37103,2941,8738,25.18,74.82,11679
NC,Lee,37105,3871,9312,29.36,70.64,13183
NC,Lenoir,37107,1746,4912,26.22,73.78,6658
NC,Lincoln,37109,2033,3446,37.11,62.89,5479
NC,McDowell,37111,9373,5831,61.65,38.35,15204
NC,Macon,37113,6984,6869,50.42,49.58,13853
NC,Madison,37115,9643,9727,49.78,50.22,19370
NC,Martin,37117,3885,5267,42.45,57.55,9152
NC,Mecklenburg,37119,3885,3143,55.28,44.72,7028
NC,Mitchell,37121,8531,5297,61.69,38.31,13828
NC,Montgomery,37123,1033,9691,9.63,90.37,10724
NC,Moore,37125,2614,4217,38.27,61.73,6831
NC,Nash,37127,6160,4966,55.37,44.63,11126
NC,New Hanover,37129,3509,6885,33.76,66.24,10394
NC,Northampton,37131,5255,8363,38.59,61.41,13618
NC,Onslow,37133,1046,1930,35.15,64.85,2976
NC,Orange,37135,7457,8391,47.05,52.95,15848
NC,Pamlico,37137,9562,595,94.14,5.86,10157
NC,Pasquotank,37139,427,2024,17.42,82.58,2451
NC,Pender,37141,9028,4538,66.55,33.45,13566
NC,Perquimans,37143,3136,8191,27.69,72.31,11327
NC,Person,37145,5402,7546,41.72,58.28,12948
NC,Pitt,37147,8910,1056,89.40,10.60,9966
NC,Polk,37149,293,9404,3.02,96.98,9697
NC,Randolph,37151,6978,766,90.11,9.89,7744
NC,Richmond,37153,9028,1189,88.36,11.64,10217
NC,Robeson,37155,7240,7604,48.77,51.23,14844
NC,Rockingham,37157,4111,7583,35.15,64.85,11694
NC,Rowan,37159,4983,5093,49.45,50.55,10076
NC,Rutherford,37161,9376,3441,73.15,26.85,12817
NC,Sampson,37163,7654,6143,55.48,44.52,13797
NC,Scotland,37165,6636,7195,47.98,52.02,13831
NC,Stanly,37167,5468,2505,68.58,31.42,7973
NC,Stokes,37169,1425,8416,14.48,85.52,9841
NC,Surry,37171,1074,7003,13.30,86.70,8077
NC,Swain,37173,2071,3682,36.00,64.00,5753
NC,Transylvania,37175,4032,5950,40.39,59.61,9982
NC,Tyrrell,37177,8816,8082,52.17,47.83,16898
NC,Union,37179,4928,7712,38.99,61.01,12640
NC,Vance,37181,5321,7305,42.14,57.86,12626
NC,Wake,37183,7240,1680,81.17,18.83,8920
NC,Warren,37185,9741,813,92.30,7.70,10554
NC,Washington,37187,3591,5306,40.36,59.64,8897
NC,Watauga,37189,2439,4553,34.88,65.12,6992
NC,Wayne,37191,1100,1700,39.29,60.71,2800
NC,Wilkes,37193,5227,8642,37.69,62.31,13869
NC,Wilson,37195,587,122,82.79,17.21,709
NC,Yadkin,37197,3222,6502,33.13,66.87,9724
NC,Yancey,37199,7525,1603,82.44,17.56,9128
CO,Adams,8001,4799,9639,33.24,66.76,14438
CO,Alamosa,8003,6231,8231,43.09,56.91,14462
CO,Arapahoe,8005,6359,1421,81.74,18.26,7780
CO,Archuleta,8007,3216,7591,29.76,70.24,10807
CO,Baca,8009,1663,1383,54.60,45.40,3046
CO,Bent,8011,9459,5651,62.60,37.40,15110
CO,Boulder,8013,657,3417,16.13,83.87,4074
CO,Broomfield,8014,7972,7647,51.04,48.96,15619
CO,Chaffee,8015,5740,2931,66.20,33.80,8671
CO,Cheyenne,8017,8844,7969,52.60,47.40,16813
CO,Clear Creek,8019,8619,9534,47.48,52.52,18153
CO,Conejos,8021,3552,7705,31.55,68.45,11257
CO,Costilla,8023,4861,6367,43.29,56.71,11228
CO,Crowley,8025,8321,3857,68.33,31.67,12178
CO,Custer,8027,6800,5467,55.43,44.57,12267
CO,Delta,8029,3769,835,81.86,18.14,4604
CO,Denver,8031,5790,900,86.55,13.45,6690
CO,Dolores,8033,980,5537,15.04,84.96,6517
CO,Douglas,8035,9730,2943,76.78,23.22,12673
CO,Eagle,8037,968,1140,45.92,54.08,2108
CO,Elbert,8039,5928,4476,56.98,43.02,10404
CO,El Paso,8041,9189,8457,52.07,47.93,17646
CO,Fremont,8043,4796,8906,35.00,65.00,13702
CO,Garfield,8045,7276,358,95.31,4.69,7634
CO,Gilpin,8047,2394,8576,21.82,78.18,10970
CO,Grand,8049,3197,9736,24.72,75.28,12933
CO,Gunnison,8051,1336,8347,13.80,86.20,9683
CO,Hinsdale,8053,7899,9305,45.91,54.09,17204
CO,Huerfano,8055,5045,9802,33.98,66.02,14847
CO,Jackson,8057,5586,6041,48.04,51.96,11627
CO,Jefferson,8059,3526,3273,51.86,48.14,6799
CO,Kiowa,8061,5325,8367,38.89,61.11,13692
CO,Kit Carson,8063,2980,4726,38.67,61.33,7706
CO,Lake,8065,1250,8170,13.27,86.73,9420
CO,La Plata,8067,9035,4648,66.03,33.97,13683
CO,Larimer,8069,8009,8915,47.32,52.68,16924
CO,Las Animas,8071,4174,2430,63.20,36.80,6604
CO,Lincoln,8073,6487,4721,57.88,42.12,11208
CO,Logan,8075,6658,8632,43.54,56.46,15290
CO,Mesa,8077,3126,2750,53.20,46.80,5876
CO,Mineral,8079,3415,1622,67.80,32.20,5037
CO,Moffat,8081,8890,7841,53.13,46.87,16731
CO,Montezuma,8083,9634,4888,66.34,33.66,14522
CO,Montrose,8085,2281,9002,20.22,79.78,11283
CO,Morgan,8087,836,8746,8.72,91.28,9582
CO,Otero,8089,8569,827,91.20,8.80,9396
CO,Ouray,8091,6174,4736,56.59,43.41,10910
CO,Park,8093,3242,8214,28.30,71.70,11456
CO,Phillips,8095,7848,4046,65.98,34.02,11894
CO,Pitkin,8097,1008,2911,25.72,74.28,3919
CO,Prowers,8099,7283,2671,73.17,26.83,9954
CO,Pueblo,8101,3717,706,84.04,15.96,4423
CO,Rio Blanco,8103,1354,2648,33.83,66.17,4002
CO,Rio Grande,8105,7292,6688,52.16,47.84,13980
CO,Routt,8107,359,7995,4.30,95.70,8354
CO,Saguache,8109,7694,2889,72.70,27.30,10583
CO,San Juan,8111,6134,1794,77.37,22.63,7928
CO,San Miguel,8113,7596,4746,61.55,38.45,12342
CO,Sedgwick,8115,1347,3032,30.76,69.24,4379
CO,Summit,8117,5685,2985,65.57,34.43,8670
CO,Teller,8119,9482,4525,67.69,32.31,14007
CO,Washington,8121,4459,6583,40.38,59.62,11042
CO,Weld,8123,9592,1594,85.75,14.25,11186
CO,Yuma,8125,9441,4335,68.53,31.47,13776