state,key,code,r,d,rp,dp,t,p
KY,Adair,21001,3856,4651,0.45,0.55,8507,99
KY,Allen,21003,9260,4191,0.69,0.31,13451,99
KY,Anderson,21005,3596,5550,0.39,0.61,9146,99
KY,Ballard,21007,2034,1849,0.52,0.48,3883,99
KY,Barren,21009,5757,6025,0.49,0.51,11782,99
KY,Bath,21011,7111,1172,0.86,0.14,8283,99
KY,Bell,21013,6274,3274,0.66,0.34,9548,99
KY,Boone,21015,2835,159,0.95,0.05,2994,99
KY,Bourbon,21017,575,2975,0.16,0.84,3550,89
KY,Boyd,21019,6707,1556,0.81,0.19,8263,99
KY,Boyle,21021,9370,2688,0.78,0.22,12058,99
KY,Bracken,21023,2405,942,0.72,0.28,3347,99
KY,Breathitt,21025,9020,5825,0.61,0.39,14845,99
KY,Breckinridge,21027,4633,1444,0.76,0.24,6077,99
KY,Bullitt,21029,3403,3736,0.48,0.52,7139,99
KY,Butler,21031,404,6894,0.06,0.94,7298,95
KY,Caldwell,21033,2195,2733,0.45,0.55,4928,97
KY,Calloway,21035,1977,3001,0.40,0.60,4978,99
KY,Campbell,21037,3822,8290,0.32,0.68,12112,96
KY,Carlisle,21039,2099,4699,0.31,0.69,6798,99
KY,Carroll,21041,7352,559,0.93,0.07,7911,99
KY,Carter,21043,1305,3709,0.26,0.74,5014,99
KY,Casey,21045,6387,5604,0.53,0.47,11991,99
KY,Christian,21047,9634,9608,0.50,0.50,19242,93
KY,Clark,21049,6879,2823,0.71,0.29,9702,99
KY,Clay,21051,4996,4033,0.55,0.45,9029,99
KY,Clinton,21053,5370,3244,0.62,0.38,8614,91
KY,Crittenden,21055,9518,823,0.92,0.08,10341,99
KY,Cumberland,21057,3071,6168,0.33,0.67,9239,99
KY,Daviess,21059,1911,416,0.82,0.18,2327,99
KY,Edmonson,21061,1869,1826,0.51,0.49,3695,90
KY,Elliott,21063,4238,891,0.83,0.17,5129,99
KY,Estill,21065,3042,7921,0.28,0.72,10963,99
KY,Fayette,21067,9988,1220,0.89,0.11,11208,99
KY,Fleming,21069,258,578,0.31,0.69,836,99
KY,Floyd,21071,9407,6124,0.61,0.39,15531,92
KY,Franklin,21073,9298,1590,0.85,0.15,10888,99
KY,Fulton,21075,5594,2691,0.68,0.32,8285,99
KY,Gallatin,21077,129,719,0.15,0.85,848,99
KY,Garrard,21079,856,3444,0.20,0.80,4300,99
KY,Grant,21081,9894,9225,0.52,0.48,19119,99
KY,Graves,21083,9226,3601,0.72,0.28,12827,99
KY,Grayson,21085,6567,2170,0.75,0.25,8737,99
KY,Green,21087,7526,209,0.97,0.03,7735,99
KY,Greenup,21089,335,7468,0.04,0.96,7803,99
KY,Hancock,21091,406,9136,0.04,0.96,9542,99
KY,Hardin,21093,1430,4458,0.24,0.76,5888,99
KY,Harlan,21095,138,6383,0.02,0.98,6521,99
KY,Harrison,21097,9177,4909,0.65,0.35,14086,99
KY,Hart,21099,6500,2176,0.75,0.25,8676,99
KY,Henderson,21101,3667,3501,0.51,0.49,7168,99
KY,Henry,21103,3298,2846,0.54,0.46,6144,99
KY,Hickman,21105,1554,3211,0.33,0.67,4765,99
KY,Hopkins,21107,6521,8717,0.43,0.57,15238,99
KY,Jackson,21109,1471,9437,0.13,0.87,10908,99
KY,Jefferson,21111,6734,149,0.98,0.02,6883,99
KY,Jessamine,21113,196,3970,0.05,0.95,4166,99
KY,Johnson,21115,2219,9107,0.20,0.80,11326,99
KY,Kenton,21117,7422,9598,0.44,0.56,17020,99
KY,Knott,21119,9915,5652,0.64,0.36,15567,99
KY,Knox,21121,6928,5841,0.54,0.46,12769,99
KY,Larue,21123,1552,9461,0.14,0.86,11013,99
KY,Laurel,21125,9528,2368,0.80,0.20,11896,99
KY,Lawrence,21127,4210,4861,0.46,0.54,9071,99
KY,Lee,21129,6885,135,0.98,0.02,7020,99
KY,Leslie,21131,6453,6047,0.52,0.48,12500,99
KY,Letcher,21133,572,4861,0.11,0.89,5433,99
KY,Lewis,21135,5773,3805,0.60,0.40,9578,99
KY,Lincoln,21137,5461,4576,0.54,0.46,10037,99
KY,Livingston,21139,8910,7651,0.54,0.46,16561,99
KY,Logan,21141,975,5070,0.16,0.84,6045,99
KY,Lyon,21143,6067,9984,0.38,0.62,16051,99
KY,McCracken,21145,372,7607,0.05,0.95,7979,99
KY,McCreary,21147,7182,847,0.89,0.11,8029,99
KY,McLean,21149,6157,7843,0.44,0.56,14000,99
KY,Madison,21151,1038,7634,0.12,0.88,8672,99
KY,Magoffin,21153,1987,9059,0.18,0.82,11046,99
KY,Marion,21155,186,7597,0.02,0.98,7783,99
KY,Marshall,21157,6662,2290,0.74,0.26,8952,99
KY,Martin,21159,3222,8582,0.27,0.73,11804,99
KY,Mason,21161,2493,8600,0.22,0.78,11093,99
KY,Meade,21163,4792,2188,0.69,0.31,6980,99
KY,Menifee,21165,6181,8713,0.41,0.59,14894,99
KY,Mercer,21167,6870,2788,0.71,0.29,9658,99
KY,Metcalfe,21169,636,5625,0.10,0.90,6261,99
KY,Monroe,21171,7838,511,0.94,0.06,8349,79
KY,Montgomery,21173,9653,4568,0.68,0.32,14221,99
KY,Morgan,21175,6711,9430,0.42,0.58,16141,99
KY,Muhlenberg,21177,7127,5278,0.57,0.43,12405,99
KY,Nelson,21179,1908,1091,0.64,0.36,2999,99
KY,Nicholas,21181,9833,7173,0.58,0.42,17006,99
KY,Ohio,21183,2611,6146,0.30,0.70,8757,99
KY,Oldham,21185,9259,2092,0.82,0.18,11351,99
KY,Owen,21187,8355,3666,0.70,0.30,12021,99
KY,Owsley,21189,6747,6483,0.51,0.49,13230,99
KY,Pendleton,21191,7398,4093,0.64,0.36,11491,99
KY,Perry,21193,5994,1840,0.77,0.23,7834,99
KY,Pike,21195,4120,1161,0.78,0.22,5281,99
KY,Powell,21197,1017,2776,0.27,0.73,3793,99
KY,Pulaski,21199,2232,6550,0.25,0.75,8782,99
KY,Robertson,21201,3121,5033,0.38,0.62,8154,99
KY,Rockcastle,21203,1090,1319,0.45,0.55,2409,99
KY,Rowan,21205,363,7324,0.05,0.95,7687,99
KY,Russell,21207,5789,1718,0.77,0.23,7507,99
KY,Scott,21209,785,317,0.71,0.29,1102,99
KY,Shelby,21211,7042,9596,0.42,0.58,16638,99
KY,Simpson,21213,9202,3179,0.74,0.26,12381,99
KY,Spencer,21215,1851,2037,0.48,0.52,3888,99
KY,Taylor,21217,6786,9273,0.42,0.58,16059,99
KY,Todd,21219,6605,8132,0.45,0.55,14737,99
KY,Trigg,21221,1124,4365,0.20,0.80,5489,99
KY,Trimble,21223,9664,4689,0.67,0.33,14353,99
KY,Union,21225,9079,5955,0.60,0.40,15034,99
KY,Warren,21227,7535,1089,0.87,0.13,8624,99
KY,Washington,21229,8109,2248,0.78,0.22,10357,99
KY,Wayne,21231,4423,319,0.93,0.07,4742,99
KY,Webster,21233,9515,2765,0.77,0.23,12280,99
KY,Whitley,21235,3381,599,0.85,0.15,3980,99
KY,Wolfe,21237,7816,2247,0.78,0.22,10063,99
KY,Woodford,21239,2653,5288,0.33,0.67,7941,99
IA,Adair,19001,7258,6389,0.53,0.47,13647,99
IA,Adams,19003,7641,4125,0.65,0.35,11766,99
IA,Allamakee,19005,8925,9893,0.47,0.53,18818,99
IA,Appanoose,19007,1165,5811,0.17,0.83,6976,99
IA,Audubon,19009,3242,9232,0.26,0.74,12474,99
IA,Benton,19011,7818,4401,0.64,0.36,12219,99
IA,Black Hawk,19013,765,5959,0.11,0.89,6724,99
IA,Boone,19015,139,798,0.15,0.85,937,99
IA,Bremer,19017,3253,3988,0.45,0.55,7241,99
IA,Buchanan,19019,9592,6514,0.60,0.40,16106,99
IA,Buena Vista,19021,3630,8182,0.31,0.69,11812,99
IA,Butler,19023,4454,4382,0.50,0.50,8836,99
IA,Calhoun,19025,7581,4969,0.60,0.40,12550,99
IA,Carroll,19027,8415,1324,0.86,0.14,9739,99
IA,Cass,19029,2231,1139,0.66,0.34,3370,99
IA,Cedar,19031,7836,4475,0.64,0.36,12311,99
IA,Cerro Gordo,19033,8325,3120,0.73,0.27,11445,99
IA,Cherokee,19035,1920,128,0.94,0.06,2048,99
IA,Chickasaw,19037,3740,2902,0.56,0.44,6642,99
IA,Clarke,19039,6929,5792,0.54,0.46,12721,99
IA,Clay,19041,9165,1144,0.89,0.11,10309,99
IA,Clayton,19043,5834,3030,0.66,0.34,8864,99
IA,Clinton,19045,3117,9462,0.25,0.75,12579,99
IA,Crawford,19047,1157,1350,0.46,0.54,2507,99
IA,Dallas,19049,6816,7419,0.48,0.52,14235,99
IA,Davis,19051,289,1587,0.15,0.85,1876,99
IA,Decatur,19053,5518,357,0.94,0.06,5875,99
IA,Delaware,19055,9580,8652,0.53,0.47,18232,99
IA,Des Moines,19057,7218,4532,0.61,0.39,11750,99
IA,Dickinson,19059,4229,4133,0.51,0.49,8362,99
IA,Dubuque,19061,2634,4260,0.38,0.62,6894,99
IA,Emmet,19063,2809,4421,0.39,0.61,7230,99
IA,Fayette,19065,5053,5282,0.49,0.51,10335,99
IA,Floyd,19067,8818,7042,0.56,0.44,15860,99
IA,Franklin,19069,6503,3787,0.63,0.37,10290,99
IA,Fremont,19071,1317,5067,0.21,0.79,6384,99
IA,Greene,19073,8456,7544,0.53,0.47,16000,99
IA,Grundy,19075,7052,4306,0.62,0.38,11358,99
IA,Guthrie,19077,3033,2873,0.51,0.49,5906,99
IA,Hamilton,19079,6439,311,0.95,0.05,6750,99
IA,Hancock,19081,8076,9682,0.45,0.55,17758,99
IA,Hardin,19083,7428,2799,0.73,0.27,10227,99
IA,Harrison,19085,990,8513,0.10,0.90,9503,99
IA,Henry,19087,7478,8945,0.46,0.54,16423,99
IA,Howard,19089,1602,2616,0.38,0.62,4218,99
IA,Humboldt,19091,3453,462,0.88,0.12,3915,99
IA,Ida,19093,6591,9664,0.41,0.59,16255,99
IA,Iowa,0,3443,7436,0.32,0.68,10879,99
IA,Jackson,19097,5305,6245,0.46,0.54,11550,99
IA,Jasper,19099,6119,2172,0.74,0.26,8291,99
IA,Jefferson,19101,5674,2424,0.70,0.30,8098,99
IA,Johnson,19103,5699,6265,0.48,0.52,11964,99
IA,Jones,19105,8044,4041,0.67,0.33,12085,99
IA,Keokuk,19107,3817,7179,0.35,0.65,10996,99
IA,Kossuth,19109,897,2460,0.27,0.73,3357,99
IA,Lee,19111,1203,7499,0.14,0.86,8702,99
IA,Linn,19113,3038,4652,0.40,0.60,7690,99
IA,Louisa,19115,5893,4747,0.55,0.45,10640,99
IA,Lucas,19117,534,4894,0.10,0.90,5428,99
IA,Lyon,19119,2739,8442,0.24,0.76,11181,99
IA,Madison,19121,7191,2544,0.74,0.26,9735,99
IA,Mahaska,19123,6010,4795,0.56,0.44,10805,99
IA,Marion,19125,1689,7656,0.18,0.82,9345,99
IA,Marshall,19127,9277,455,0.95,0.05,9732,99
IA,Mills,19129,1291,268,0.83,0.17,1559,99
IA,Mitchell,19131,6219,3326,0.65,0.35,9545,99
IA,Monona,19133,1401,5428,0.21,0.79,6829,99
IA,Monroe,19135,7235,1081,0.87,0.13,8316,99
IA,Montgomery,19137,8461,7572,0.53,0.47,16033,99
IA,Muscatine,19139,5009,5353,0.48,0.52,10362,99
IA,O'Brien,19141,7928,686,0.92,0.08,8614,99
IA,Osceola,19143,331,3981,0.08,0.92,4312,99
IA,Page,19145,4702,4619,0.50,0.50,9321,99
IA,Palo Alto,19147,1399,4919,0.22,0.78,6318,99
IA,Plymouth,19149,1463,3866,0.27,0.73,5329,99
IA,Pocahontas,19151,1420,7923,0.15,0.85,9343,99
IA,Polk,19153,3152,8930,0.26,0.74,12082,99
IA,Pottawattamie,19155,5246,8641,0.38,0.62,13887,99
IA,Poweshiek,19157,9736,5438,0.64,0.36,15174,99
IA,Ringgold,19159,885,9305,0.09,0.91,10190,99
IA,Sac,19161,9976,6675,0.60,0.40,16651,99
IA,Scott,19163,2446,4466,0.35,0.65,6912,99
IA,Shelby,19165,6396,2928,0.69,0.31,9324,99
IA,Sioux,19167,6261,6467,0.49,0.51,12728,99
IA,Story,19169,3814,5929,0.39,0.61,9743,99
IA,Tama,19171,9364,2887,0.76,0.24,12251,99
IA,Taylor,19173,1146,7146,0.14,0.86,8292,99
IA,Union,19175,6383,7595,0.46,0.54,13978,99
IA,Van Buren,19177,8915,8671,0.51,0.49,17586,99
IA,Wapello,19179,6620,511,0.93,0.07,7131,99
IA,Warren,19181,5295,9622,0.35,0.65,14917,99
IA,Washington,19183,9197,7650,0.55,0.45,16847,99
IA,Wayne,19185,9318,6327,0.60,0.40,15645,99
IA,Webster,19187,3261,580,0.85,0.15,3841,99
IA,Winnebago,19189,7393,7090,0.51,0.49,14483,99
IA,Winneshiek,19191,3669,2687,0.58,0.42,6356,99
IA,Woodbury,19193,9812,4640,0.68,0.32,14452,99
IA,Worth,19195,1674,3396,0.33,0.67,5070,99
IA,Wright,19197,5380,8020,0.40,0.60,13400,99
GA,Appling,13001,9169,5095,0.64,0.36,14264,99
GA,Atkinson,13003,9175,2009,0.82,0.18,11184,99
GA,Bacon,13005,4245,8638,0.33,0.67,12883,99
GA,Baker,13007,7679,4774,0.62,0.38,12453,99
GA,Baldwin,13009,8265,4085,0.67,0.33,12350,99
GA,Banks,13011,7835,4312,0.65,0.35,12147,99
GA,Barrow,13013,8510,1444,0.85,0.15,9954,99
GA,Bartow,13015,4600,8349,0.36,0.64,12949,99
GA,Ben Hill,13017,9790,6061,0.62,0.38,15851,99
GA,Berrien,13019,9113,592,0.94,0.06,9705,99
GA,Bibb,13021,9164,9274,0.50,0.50,18438,99
GA,Bleckley,13023,3067,2959,0.51,0.49,6026,99
GA,Brantley,13025,6512,1346,0.83,0.17,7858,99
GA,Brooks,13027,1438,1513,0.49,0.51,2951,99
GA,Bryan,13029,2503,1474,0.63,0.37,3977,99
GA,Bulloch,13031,2386,3441,0.41,0.59,5827,99
GA,Burke,13033,6457,7874,0.45,0.55,14331,99
GA,Butts,13035,1254,2291,0.35,0.65,3545,99
GA,Calhoun,13037,4571,8358,0.35,0.65,12929,99
GA,Camden,13039,1092,8190,0.12,0.88,9282,99
GA,Candler,13043,9223,596,0.94,0.06,9819,99
GA,Carroll,13045,6064,3922,0.61,0.39,9986,99
GA,Catoosa,13047,5716,6792,0.46,0.54,12508,99
GA,Charlton,13049,8284,7542,0.52,0.48,15826,99
GA,Chatham,13051,5551,1763,0.76,0.24,7314,99
GA,Chattahoochee,13053,3099,2076,0.60,0.40,5175,99
GA,Chattooga,13055,6897,2088,0.77,0.23,8985,99
GA,Cherokee,13057,8909,1616,0.85,0.15,10525,99
GA,Clarke,13059,9608,1438,0.87,0.13,11046,99
GA,Clay,13061,5945,2902,0.67,0.33,8847,99
GA,Clayton,13063,2287,1583,0.59,0.41,3870,99
GA,Clinch,13065,1773,2819,0.39,0.61,4592,99
GA,Cobb,13067,335,8254,0.04,0.96,8589,99
GA,Coffee,13069,8301,7113,0.54,0.46,15414,99
GA,Colquitt,13071,7182,8490,0.46,0.54,15672,99
GA,Columbia,13073,1251,4181,0.23,0.77,5432,99
GA,Cook,13075,6128,6769,0.48,0.52,12897,99
GA,Coweta,13077,9380,6550,0.59,0.41,15930,99
GA,Crawford,13079,6895,444,0.94,0.06,7339,99
GA,Crisp,13081,8473,5871,0.59,0.41,14344,99
GA,Dade,13083,8196,3731,0.69,0.31,11927,99
GA,Dawson,13085,4604,3027,0.60,0.40,7631,99
GA,Decatur,13087,6576,8690,0.43,0.57,15266,99
GA,DeKalb,13089,8745,9136,0.49,0.51,17881,99
GA,Dodge,13091,8565,4430,0.66,0.34,12995,99
GA,Dooly,13093,2068,3536,0.37,0.63,5604,99
GA,Dougherty,13095,9144,3149,0.74,0.26,12293,99
GA,Douglas,13097,7947,6568,0.55,0.45,14515,99
GA,Early,13099,5958,2814,0.68,0.32,8772,99
GA,Echols,13101,7666,3597,0.68,0.32,11263,99
GA,Effingham,13103,3292,5086,0.39,0.61,8378,99
GA,Elbert,13105,8978,3634,0.71,0.29,12612,99
GA,Emanuel,13107,2930,911,0.76,0.24,3841,99
GA,Evans,13109,168,2853,0.06,0.94,3021,99
GA,Fannin,13111,695,5072,0.12,0.88,5767,99
GA,Fayette,13113,870,458,0.66,0.34,1328,99
GA,Floyd,13115,1141,6319,0.15,0.85,7460,99
GA,Forsyth,13117,1806,5469,0.25,0.75,7275,99
GA,Franklin,13119,5557,8062,0.41,0.59,13619,99
GA,Fulton,13121,2006,9955,0.17,0.83,11961,99
GA,Gilmer,13123,8584,2470,0.78,0.22,11054,99
GA,Glascock,13125,8018,5839,0.58,0.42,13857,99
GA,Glynn,13127,5218,2649,0.66,0.34,7867,99
GA,Gordon,13129,1909,2895,0.40,0.60,4804,99
GA,Grady,13131,1089,8832,0.11,0.89,9921,99
GA,Greene,13133,3908,9158,0.30,0.70,13066,99
GA,Gwinnett,13135,4480,3081,0.59,0.41,7561,99
GA,Habersham,13137,2219,8526,0.21,0.79,10745,99
GA,Hall,13139,5019,7961,0.39,0.61,12980,99
GA,Hancock,13141,6044,6859,0.47,0.53,12903,99
GA,Haralson,13143,2475,1895,0.57,0.43,4370,99
GA,Harris,13145,265,361,0.42,0.58,626,99
GA,Hart,13147,3331,7055,0.32,0.68,10386,99
GA,Heard,13149,445,3049,0.13,0.87,3494,99
GA,Henry,13151,9246,8120,0.53,0.47,17366,99
GA,Houston,13153,1128,6597,0.15,0.85,7725,99
GA,Irwin,13155,787,1724,0.31,0.69,2511,99
GA,Jackson,13157,7902,5989,0.57,0.43,13891,99
GA,Jasper,13159,9507,9211,0.51,0.49,18718,99
GA,Jeff Davis,13161,4659,9190,0.34,0.66,13849,99
GA,Jefferson,13163,9593,6697,0.59,0.41,16290,99
GA,Jenkins,13165,6305,9201,0.41,0.59,15506,99
GA,Johnson,13167,4970,7519,0.40,0.60,12489,99
GA,Jones,13169,665,9773,0.06,0.94,10438,99
GA,Lamar,13171,3757,5309,0.41,0.59,9066,99
GA,Lanier,13173,4565,2026,0.69,0.31,6591,99
GA,Laurens,13175,2002,2312,0.46,0.54,4314,99
GA,Lee,13177,4835,3256,0.60,0.40,8091,99
GA,Liberty,13179,5462,8058,0.40,0.60,13520,99
GA,Lincoln,13181,4820,4644,0.51,0.49,9464,99
GA,Long,13183,2562,6943,0.27,0.73,9505,99
GA,Lowndes,13185,1609,1602,0.50,0.50,3211,99
GA,Lumpkin,13187,3709,5131,0.42,0.58,8840,99
GA,Macon,13193,6594,2939,0.69,0.31,9533,99
GA,Madison,13195,1338,5789,0.19,0.81,7127,99
GA,Marion,13197,1014,8971,0.10,0.90,9985,99
GA,McDuffie,13189,7233,2711,0.73,0.27,9944,99
GA,McIntosh,13191,8203,5988,0.58,0.42,14191,99
GA,Meriwether,13199,6766,7330,0.48,0.52,14096,99
GA,Miller,13201,2602,8273,0.24,0.76,10875,99
GA,Mitchell,13205,354,7105,0.05,0.95,7459,99
GA,Monroe,13207,2949,2680,0.52,0.48,5629,89
GA,Montgomery,13209,7151,7167,0.50,0.50,14318,99
GA,Morgan,13211,3986,7528,0.35,0.65,11514,99
GA,Murray,13213,4836,4901,0.50,0.50,9737,99
GA,Muscogee,13215,2295,9066,0.20,0.80,11361,99
GA,Newton,13217,4156,6485,0.39,0.61,10641,99
GA,Oconee,13219,2464,4900,0.33,0.67,7364,99
GA,Oglethorpe,13221,6746,543,0.93,0.07,7289,99
GA,Paulding,13223,9738,9543,0.51,0.49,19281,99
GA,Peach,13225,4886,2383,0.67,0.33,7269,99
GA,Pickens,13227,3754,5712,0.40,0.60,9466,99
GA,Pierce,13229,1197,2453,0.33,0.67,3650,99
GA,Pike,13231,7581,9444,0.45,0.55,17025,99
GA,Polk,13233,8042,2551,0.76,0.24,10593,99
GA,Pulaski,13235,7006,9695,0.42,0.58,16701,99
GA,Putnam,13237,6158,3007,0.67,0.33,9165,99
GA,Quitman,13239,5593,4198,0.57,0.43,9791,99
GA,Rabun,13241,2369,6926,0.25,0.75,9295,99
GA,Randolph,13243,9596,1486,0.87,0.13,11082,99
GA,Richmond,13245,4516,7210,0.39,0.61,11726,99
GA,Rockdale,13247,3789,9839,0.28,0.72,13628,99
GA,Schley,13249,1540,8881,0.15,0.85,10421,99
GA,Screven,13251,8255,9550,0.46,0.54,17805,99
GA,Seminole,13253,9357,4233,0.69,0.31,13590,99
GA,Spalding,13255,7711,6690,0.54,0.46,14401,99
GA,Stephens,13257,301,6845,0.04,0.96,7146,99
GA,Stewart,13259,772,989,0.44,0.56,1761,99
GA,Sumter,13261,2422,7492,0.24,0.76,9914,99
GA,Talbot,13263,8305,6699,0.55,0.45,15004,99
GA,Taliaferro,13265,2395,7556,0.24,0.76,9951,99
GA,Tattnall,13267,6410,2086,0.75,0.25,8496,99
GA,Taylor,13269,1430,6767,0.17,0.83,8197,99
GA,Telfair,13271,7535,2739,0.73,0.27,10274,99
GA,Terrell,13273,861,4876,0.15,0.85,5737,99
GA,Thomas,13275,5242,5857,0.47,0.53,11099,99
GA,Tift,13277,4848,9971,0.33,0.67,14819,99
GA,Toombs,13279,9119,8588,0.51,0.49,17707,99
GA,Towns,13281,6400,7633,0.46,0.54,14033,99
GA,Treutlen,13283,5465,8305,0.40,0.60,13770,99
GA,Troup,13285,4865,462,0.91,0.09,5327,99
GA,Turner,13287,1641,4494,0.27,0.73,6135,99
GA,Twiggs,13289,9015,6139,0.59,0.41,15154,99
GA,Union,13291,6977,977,0.88,0.12,7954,99
GA,Upson,13293,1243,5181,0.19,0.81,6424,99
GA,Walker,13295,528,1004,0.34,0.66,1532,99
GA,Walton,13297,4608,3435,0.57,0.43,8043,99
GA,Ware,13299,9137,8792,0.51,0.49,17929,99
GA,Warren,13301,3629,6054,0.37,0.63,9683,99
GA,Washington,13303,6081,4301,0.59,0.41,10382,99
GA,Wayne,13305,2138,7462,0.22,0.78,9600,99
GA,Webster,13307,763,9926,0.07,0.93,10689,99
GA,Wheeler,13309,1363,9974,0.12,0.88,11337,99
GA,White,13311,4787,8006,0.37,0.63,12793,99
GA,Whitfield,13313,7270,9688,0.43,0.57,16958,99
GA,Wilcox,13315,1692,2497,0.40,0.60,4189,99
GA,Wilkes,13317,2107,9590,0.18,0.82,11697,99
GA,Wilkinson,13319,478,6163,0.07,0.93,6641,99
GA,Worth,13321,4810,9172,0.34,0.66,13982,99
NC,Alamance,37001,3737,9013,0.29,0.71,12750,99
NC,Alexander,37003,8538,494,0.95,0.05,9032,99
NC,Alleghany,37005,3511,309,0.92,0.08,3820,99
NC,Anson,37007,9622,6278,0.61,0.39,15900,99
NC,Ashe,37009,4189,6496,0.39,0.61,10685,99
NC,Avery,37011,2013,852,0.70,0.30,2865,99
NC,Beaufort,37013,6925,7851,0.47,0.53,14776,99
NC,Bertie,37015,2289,6316,0.27,0.73,8605,99
NC,Bladen,37017,5158,9389,0.35,0.65,14547,99
NC,Brunswick,37019,7051,5557,0.56,0.44,12608,99
NC,Buncombe,37021,1647,9992,0.14,0.86,11639,99
NC,Burke,37023,3657,1923,0.66,0.34,5580,99
NC,Cabarrus,37025,6700,5002,0.57,0.43,11702,99
NC,Caldwell,37027,2648,2776,0.49,0.51,5424,99
NC,Camden,37029,5679,5227,0.52,0.48,10906,99
NC,Carteret,37031,4506,3721,0.55,0.45,8227,99
NC,Caswell,37033,1951,4546,0.30,0.70,6497,99
NC,Catawba,37035,7715,1534,0.83,0.17,9249,99
NC,Chatham,37037,9299,8063,0.54,0.46,17362,99
NC,Cherokee,37039,8661,8009,0.52,0.48,16670,99
NC,Chowan,37041,8000,8122,0.50,0.50,16122,99
NC,Clay,37043,749,1940,0.28,0.72,2689,99
NC,Cleveland,37045,4149,4864,0.46,0.54,9013,99
NC,Columbus,37047,2353,8511,0.22,0.78,10864,99
NC,Craven,37049,8209,9465,0.46,0.54,17674,99
NC,Cumberland,37051,8141,2912,0.74,0.26,11053,99
NC,Currituck,37053,2071,1087,0.66,0.34,3158,99
NC,Dare,37055,7216,7968,0.48,0.52,15184,99
NC,Davidson,37057,5281,1325,0.80,0.20,6606,99
NC,Davie,37059,8238,2389,0.78,0.22,10627,99
NC,Duplin,37061,1134,9121,0.11,0.89,10255,99
NC,Durham,37063,5495,5684,0.49,0.51,11179,99
NC,Edgecombe,37065,3424,5867,0.37,0.63,9291,99
NC,Forsyth,37067,4923,7988,0.38,0.62,12911,99
NC,Franklin,37069,3609,145,0.96,0.04,3754,99
NC,Gaston,37071,4753,636,0.88,0.12,5389,99
NC,Gates,37073,155,998,0.13,0.87,1153,99
NC,Graham,37075,447,9542,0.04,0.96,9989,99
NC,Granville,37077,1734,7446,0.19,0.81,9180,99
NC,Greene,37079,7482,9364,0.44,0.56,16846,99
NC,Guilford,37081,986,8221,0.11,0.89,9207,99
NC,Halifax,37083,8382,697,0.92,0.08,9079,99
NC,Harnett,37085,3500,3146,0.53,0.47,6646,99
NC,Haywood,37087,8931,3387,0.73,0.27,12318,99
NC,Henderson,37089,9731,9045,0.52,0.48,18776,99
NC,Hertford,37091,618,5216,0.11,0.89,5834,99
NC,Hoke,37093,996,5767,0.15,0.85,6763,99
NC,Hyde,37095,3325,5139,0.39,0.61,8464,99
NC,Iredell,37097,4410,2222,0.66,0.34,6632,99
NC,Jackson,37099,4202,2894,0.59,0.41,7096,99
NC,Johnston,37101,2697,6497,0.29,0.71,9194,99
NC,Jones,37103,2941,8738,0.25,0.75,11679,99
NC,Lee,37105,3871,9312,0.29,0.71,13183,99
NC,Lenoir,37107,1746,4912,0.26,0.74,6658,99
NC,Lincoln,37109,2033,3446,0.37,0.63,5479,99
NC,McDowell,37111,9373,5831,0.62,0.38,15204,99
NC,Macon,37113,6984,6869,0.50,0.50,13853,99
NC,Madison,37115,9643,9727,0.50,0.50,19370,99
NC,Martin,37117,3885,5267,0.42,0.58,9152,99
NC,Mecklenburg,37119,3885,3143,0.55,0.45,7028,99
NC,Mitchell,37121,8531,5297,0.62,0.38,13828,99
NC,Montgomery,37123,1033,9691,0.10,0.90,10724,99
NC,Moore,37125,2614,4217,0.38,0.62,6831,99
NC,Nash,37127,6160,4966,0.55,0.45,11126,99
NC,New Hanover,37129,3509,6885,0.34,0.66,10394,99
NC,Northampton,37131,5255,8363,0.39,0.61,13618,99
NC,Onslow,37133,1046,1930,0.35,0.65,2976,99
NC,Orange,37135,7457,8391,0.47,0.53,15848,99
NC,Pamlico,37137,9562,595,0.94,0.06,10157,99
NC,Pasquotank,37139,427,2024,0.17,0.83,2451,99
NC,Pender,37141,9028,4538,0.67,0.33,13566,99
NC,Perquimans,37143,3136,8191,0.28,0.72,11327,99
NC,Person,37145,5402,7546,0.42,0.58,12948,99
NC,Pitt,37147,8910,1056,0.89,0.11,9966,99
NC,Polk,37149,293,9404,0.03,0.97,9697,99
NC,Randolph,37151,6978,766,0.90,0.10,7744,99
NC,Richmond,37153,9028,1189,0.88,0.12,10217,99
NC,Robeson,37155,7240,7604,0.49,0.51,14844,99
NC,Rockingham,37157,4111,7583,0.35,0.65,11694,99
NC,Rowan,37159,4983,5093,0.49,0.51,10076,99
NC,Rutherford,37161,9376,3441,0.73,0.27,12817,99
NC,Sampson,37163,7654,6143,0.55,0.45,13797,99
NC,Scotland,37165,6636,7195,0.48,0.52,13831,99
NC,Stanly,37167,5468,2505,0.69,0.31,7973,99
NC,Stokes,37169,1425,8416,0.14,0.86,9841,99
NC,Surry,37171,1074,7003,0.13,0.87,8077,99
NC,Swain,37173,2071,3682,0.36,0.64,5753,99
NC,Transylvania,37175,4032,5950,0.40,0.60,9982,99
NC,Tyrrell,37177,8816,8082,0.52,0.48,16898,99
NC,Union,37179,4928,7712,0.39,0.61,12640,99
NC,Vance,37181,5321,7305,0.42,0.58,12626,99
NC,Wake,37183,7240,1680,0.81,0.19,8920,99
NC,Warren,37185,9741,813,0.92,0.08,10554,99
NC,Washington,37187,3591,5306,0.40,0.60,8897,99
NC,Watauga,37189,2439,4553,0.35,0.65,6992,99
NC,Wayne,37191,1100,1700,0.39,0.61,2800,99
NC,Wilkes,37193,5227,8642,0.38,0.62,13869,99
NC,Wilson,37195,587,122,0.83,0.17,709,99
NC,Yadkin,37197,3222,6502,0.33,0.67,9724,99
NC,Yancey,37199,7525,1603,0.82,0.18,9128,99